10
10

WAR^^^^RAW
^^^^^^^^^^
^^^^^^^^^^
^^^^^^^^^^
^^^^^^^^^^
^^^^^^^^^^
^^^^^X^^^^
^^^^^^^^^^
^^^^^^^^^^
RAW^^^^WAR

RAW^^^^WAR
^^^^^^^^^^
^^^^^^^^^^
^^^^^^^^^^
^^^^^^^^^^
^^^^^^^^^^
^^^^^^^^^^
^^^^^^^^^^
^^^^^^^^^^
RRA^^^^WWA
